####################################################################################################
#         # #   # #          # #   #     ##   #   #      # #  ##      # #        #          #   ## #
### #  #                ## ##    ###     #        # #     # # #    # #    #   #      #            ##
#  #       # #  #    #  #    #  # #   #      ### # #        # #     # # # #  #  ## #    #       #  #
# ###      #  #  #   # # # #     ##     #       #       .      #     ##      #   #                ##
# # # #        #   #        # #  #                    #         # #     #  #      ## #  #  #       #
#                #  #  #      #  # ##    ##      #    #   #   #      # #    #      # #       #  ## #
# #   # # #     #  ### #      ###  #    # #      #   # # #    #  #   #    #     #                  #
#     #  ##  #  #  #      #    ##  ##       #         ## # # # ##  ##     #    #    #           #  #
#      #  #         ##    ##  #  #   #  #       # #        #         ##  # #  #    ## #      # #   #
#   #      #      #  #       #   #  # #   #       ##  ##     #      #         # ##   #             #
#  ## ##        #     #  #        #   #    #      #           ##          #   ###   # ##           #
#  # #  #    #         #          #    ##  ##       # #  #     #         #           #      #      #
# #       #      # #           #       #        ##           #            #            #   #    #  #
#   #  #          # #        #   #             # #   #    #         #  #        #              #   #
#    #           #  #            #   #  #             ##      #     # #  #   #     ###        #    #
#   ##  #  #         #   #   #           ##      #  #                 #               #            #
# ##         ##  #      #                    #                 #             # #   #   ##  #      ##
#       #   #  #                          #    #       #  #      #       #     #     ##   #   ##  ##
#  # #        #   #   #  #   #      # #   #            ####   #         #        # #     #         #
##         ##   ## #      ##   ##   # #  ####      #  # #   ##           #         #    #     ###  #
#     #   #   #    ## #  ##                  ## #          ###  #  #        #    #     ###         #
#                                   # #   # #  #   #  #   #  #   #  #            # # # #     #     #
#          ## #       ##         ##      # ##    #    ### #   #       ### # #     ###  #     ##   ##
#         #  #  # #  #     #  #          ##  #   #       #                     #   # # #          ##
#    #  ##          #    ##        #     #            #   #      ##             #        ####  ## ##
##       #    # #         #                  ##    # #        #      # ## #             #    # #  ##
#     ##       #               # #         # # #      # #  # #         # #  #  #  # #  #      # #  #
#  ##   # ## # # # ##        # ###   #         ## ## ##                        #        #  # # ##  #
#         #   # #       # # # # ##      #   #     # # #  #            #  #  #  #        #   #    ###
#        # #                           # #   # #       ##    # #  ##      # #     # #    #  #      #
# #  #   #              ##   #   #   #   #             # #     #                      #    #       #
#  #      # #    #           # # ##          #  ###        #   ##  ##   # #   ### #  ##    ##   ## #
#   #   ##   #              #  #   #          #                    #  ##  #   ####  #       ##     #
#      #   # #     #                         #  ##  #    ##  # #   #       ###      #            ###
#       ##    ## #     #  ##   #       #       # #  #     #    # # #  #   #                  #  #  #
##         #     #  #   ##     # ##       #            #       #   ##### # ##  # ##      #         #
#  # #                  #   #     ## #      #    # #     ##  # #      ##  #  #    #     #  #   ## ##
#     #   #     ####    ###      #                      #         ###        ##   # ##   ##        #
# ##            # #       #       #                 #                                 # #     #    #
# #    #  ##    ## #     # # #             #             ## #    #         #      #     # #   #    #
#        #       ##  #    #    #          ###        #    ## ##  # #      #      ##    ###    ##  ##
#   ## #            ## # ##   # #       #         #       #            #  # #      #   #    ##  #  #
#                #     #          #     #           ## # #  P      #                ##       #     #
# #       ##         #  #    # ###    #  #  # #  #  #           #      #    # #           #        #
#####     #  #  # ##   #   #      ##   #       #  ##     #     #           # #  # #  #        #  # #
#       #  #             #       #    #     # #  #  #         #  # #      #          #     #    #  #
#              #    # ##   #         #            #    #    #    ###  #  #   ##      #    ##  ##   #
# # #  #    #      #      # #       ###  #             #             #           #  ##  #          #
####################################################################################################