####################
#   ## #       #  ##
##     P   #  ##   #
##      ## #   #   #
###  #       # ##  #
#       ##      ## #
#    # #        ## #
#    ##    # ###  ##
#  ## #   #  ###   #
# ##        #     ##
#       #   #    # #
###   #      ##    #
##       # #      ##
# # #          # # #
#   # #        #   #
#  ###  # ##  #    #
#  #     # #       #
#  # #            ##
#        #    .    #
####################