# ### #
#   # #
# # # #
# #   #
# ### #
#P  # #
#####.#