40
40
########################################
#  # #  #         # # ##      ##       #
#    #     #                #    #     #
#  #   #            #   #    ##   ##   #
# #   #     #   #  #  #         #  ##  #
#   ### #           #         #   ##   #
#    ## #               ###   #     # ##
#  # # #   #     #    #       #      # #
##  #   #    # #      #    #   #   # # #
##          #    #       #  ##   ##   ##
# #        #     #  #       #  #    #  #
##  # #  #     ## #        #      #    #
# #  ####    ##     #        #         #
#   # #     #  #     #   # # #         #
##  # #         #   #     #       #    #
#  #          ##  #    #  #      ###   #
#  # #               #      #     # # ##
#        #              #    # # #  #  #
#     #     #        # #    P #  #     #
#      #   #   ##                    # #
#        #     ##      #     # ## #  # #
##     #     # #            #  # #     #
##   #    ###      # ##     #  # # #  ##
#   #     # # # #             ##    #  #
#         #   # #    ##     ##    #  ###
##   #  ##  #      #  # #          #   #
#  #  #            # #      #          #
# # ##  # ##  #         #     #   #   ##
#  #        # # #    #     #           #
##              # ##       #      ###  #
# #    #   #  # #        #  # #        #
##  #     # #   #       # #   #  ### # #
##               #                #  # #
##        #             # #     #     ##
## #              #  #         ## # #  #
#    #   #     #    #   # #        ##  #
#.    #       #        #      #        #
#     #       #    #                #  #
# #            #   ###                 #
########################################